11111111111111111111111111111111
10000000000001000000000000100001
10000000000000000100000001100001
10000000000001000000000000100001
10000000000001111100000011111111
11111000000000000000000000000001
11111000000000000000000000000001
11110000111100000000000000000111
10000000000000000000000001100001
11110000111100000000000000000111
10000000000000000000100000000001
11000000000000000010000000000001
10000000000000010000000000000001
1PC00001000010000000000000010011
10000000000000000000011100000011
110000E1100111000000000000001111
11111111111111111111111111111111
