1111111111111111111111111
1C0000C100C00010000C00001
1E01000101111100011111111
1111100101100000000000001
1C000000C1000000000011CP1
1111001111000000000001111
100C000C01000000001000001
1C00000000C00000011100011
11000000C11000C0110000001
1000000011000010000000001
1000010010000000000000001
1111111111100100C000C0011
1111111111111111111111111
