1111111111111111111111111
1P00000100000010000000001
1001000101111100011111111
1011100101100000000000001
1000000001000000000011001
1011001111000000000000111
10000000CCCCCCC0000000001
1000000000000000011100011
1000000001100000110000001
1000000011000010000000001
10C0E10010000000000001011
1000011011100100000001111
1111111111100100000000011
1111111111111111111111111
