1111111111111111111111111
1000000100000010000000001
1001000101111100011111111
1111100101100000000000001
1000000001000000000011001
1111001111000000000000111
1000000000000000001000001
1000000000000000011100011
1100000001100000110000001
1000000011000010000000001
1PC0E10010000000000001011
1100011011100100000001111
1111111111100100000000011
1111111111111111111111111
