1111111111111111111111111111
1CCC01CCCCCCCECCCCCCCC10CCC1
1C1111C11111111111111C1111C1
1CCCCCCCCCCCCCCCCCCCCCCCCCC1
1C1111C11C11111111C11C1111C1
1C1111C11C11111111C11C1111C1
1CCCCCC11CCCC11CCCC11CCCCCC1
111111C11111C11C11111C111111
111111C11111C11C11111C111111
111111C1CCCCCCCCCCCC1C111111
111111C1C1111111111C1C111111
111111CCCCC000P00CCCCC111111
111111C1C1111CC1111C1C111111
111111C1CCCCCCCCCCCC1C111111
111111C1C1111111111C1C111111
1CCCCCCCCCCCC11CCCCCCCCCCCC1
1C1111C11111C11C11111C1111C1
1C1111C11111C11C11111C1111C1
1CCC11CCCCCCCCCCCCCCCC11CCC1
1C1C11C11C11111111C11C11C1C1
1C1C11C11C11111111C11C11C1C1
1CCCCCC11CCCCCCCCCC11CCCCCC1
1111111111111111111111111111