1111111111111
1P0011E000001
1111111111111
