111111111111111111111111
100N0000000CC00000000001
100001111100C00111111111
1C0011000000P0000E000001
111111111111111111111111
