1111111111111111111111111
1000000100000010000000001
1001000101111100011111111
10111001011000N0000000001
1000000001000000000011001
1011001111000000000000111
10000000CCCCCCC0000000001
1000000000000000011100011
1000000001100000110000001
1000000011000010000000001
10C0010010000000000001011
1P00E11011100100000001111
1111111111100100000000N11
1111111111111111111111111
