11111111111111111111111111111111111111111
1N000000000000000011111111111111111111111
11111111111111111011111111111111111111111
11111111111111111011111111111111111111111
11111111111111111011111111111111111111111
1N000000000011111011111111111111111111111
11111111111011111011111111111111111111111
11111111111011111011111111111111111111111
11111111111011111011111111111111111111111
1N000011111011111011111111111111111111111
11111011111011111011111111111111111111111
11111011111011111011111111111111111111111
11111011111011111011111111111111111111111
1N0N0PCCCCCCCCCCCCCCCCCCCCCCCCCCCCCCCCCE1
11011111011111011111111111111111111111111
1N011111011111011111111111111111111111111
11111111011111011111111111111111111111111
11111111011111011111111111111111111111111
11111111011111011111111111111111111111111
1N000000011111011111111111111111111111111
11111111111111011111111111111111111111111
11111111111111011111111111111111111111111
11111111111111011111111111111111111111111
1N000000000000011111111111111111111111111
11111111111111111111111111111111111111111
11111111111111111111111111111111111111111
11111111111111111111111111111111111111111